11111111
1000C001
10C00001
1PE00001
1CC00001
11111111