1111111111
10000000E1
1011111101
10100P0101
1000111101
1000000001
10C0000001
1000000001
1000000001
1111111111
