1111111
100E001
1000001
10C0001
1000001
1000001
10P0001
1111111