1111111111111
100C000000001
1000001100C01
1110000001101
100000E000001
100000P000001
111100000C001
1000000001101
1000C00000001
1000011100001
101110000C001
100C100000001
1111111111111
