11111111111111111111
1E100010000000000001
101010100001100C0001
100010100C0000000001
11111010001000000101
10000010000000P001C1
10111110001000000001
10000000000000001001
1000C00100000000C001
10010000000000000001
101000100C0001000001
10000100000000001001
1010000001000000C001
10000C00000000000001
11111111111111111111