1111111111111111111111111111
1C0000000000000000001C000001
1111011110111111111010111101
1111000100000000001010100001
1111110111111111101000101111
10000001C0000000101010101011
1011111101011010101C10101001
100000010101EP10101010101101
1111110101011110101010000001
1000C10001000000100010101001
1011111101011110101010101011
1CC10001000C00000010001010C1
1CC1010111111101111110111111
1CC00100000000000000000000C1
1111111111111111111111111111